##############  
#S    #      #
#     #  #   #
#        #   #
#      #     #
#   ##  #   E#
##############